111111111111111111111111111111111111111111111111111111
100000100000100000100000100000100000100000000122221111
100000000100000100000100000100000100000100000122222111
100000222222222222222222222222222222222220000122222211
100000010000010000010000010000010000010000000111111111
100000000010000010000010000010000010000010000222000001
112221222222222222222222222222222222222220000222000001
100000222222222222222222222222222222222220000222005001
100000221111111111111111111111111111111110000222000001
100000221110000000000000000020000200000110000222000001
100000221100002002000002000000000000200110000222000001
100000222000000000002000000000020000000000000222000001
100000222000000002000000002000000000000000000222000001
100000222000011000000002000002000000200200001122000001
100000222000011000002000000000000200000000011122004001
100000222000011111111111111111111111111111111122000001
100000222000022222222222222222222222222222222222000001
100000222000022222222222222222222222222222222222122211
100000222000010000010000010000010000010000010000000001
111111111000000010000010000010000010000010000010000001
112222221000022222222222222222222222222222222222000001
111222221000000001000001000001000001000001000001000001
111122221000001000001000001000001000001000001000000001
111111111111111111111111111111111111111111111111111111
